$ANSIBLE_VAULT;1.1;AES256
30326539303762613835366565663833626330653630323766636363646533386632363461623936
3034386361353062663933636465333038366231646434630a376235353933653939656331373638
64663935366163346263633461306161303132363634653030626630376230616463346335666330
6233383333346630340a373533356136336164376164386438373661333831366437346662333731
39386164336630313032356463643764363536303535383534393437343436383966643663323263
63396539663533376438336266383261666662616634393138373365636162653536666633313739
39353761316664393737303032626638393531303265393036303135333263316462313562303235
31366439313535386563643766663765333134616664653336636334643535303639636438323064
63623165643061396461386163373331353663623039373130663761663235393131313239353437
30333364353166393330323566326437333238333234323133363664386263666632303036376333
62383836663736383566313039326439316137373762633866336434616365393161386335323037
63656432623765613061323233363633323464396231336334386462396161633362306539613737
39636466393139386564356237613438666563303636626363396362373864343863356461396538
30356635656431376537653235356138393737663737393532323666373837366530353733333365
31623766666237373363633939613763656132333535343733396632373361666638303864346437
36653862316434333335353433626462396263656263333565373363363832353438363137393862
39396365333438613165623366653235373338636436323231383137353466663965373235613938
31336530306439396437613265623462313831333465393232633233356366623938616362363236
34646637353764363333363464646435396164323237343063313631353136333161383233633338
33636235313836323163386234373130623166363930343966376532663335613736363264643461
30383635353165396433393339386136663066656436323636653137363738313235646535303631
32393135353438333464643863306139663330613536363433363738303630303531313365626163
33353265393239343930613132663132373233386437303939623032316335313332663964303261
39333935646538663631306136316233633162323164363364616261643361366330323837316230
30356339633532643739363864313338336465343230643636333332386235356561616135306532
35613763373361363362653064306462373439323131306134646164386564323966323864626263
36366461326234383766323036643939663862663362646531356563663561333163336330656363
65353635386236646465
